        1111111111111111111111111
        1000100001100000000000001
        1011011001110010101010001
        1001000000000101010101001
111111111011000001110000000000001
100000000011000001110111111101111
11110111111111011100000010001
111101111111110111010100D0001    
11000000110101011100000010001    
10000000000000000D00N000D0001
10000000000000001101000010001
1100000111010101111100111000111  
11110101 1111101 101111010001
11111111 111 111 111111111111