        1111111111111111111111111
        1000100001100000000000001
        10110110011101D1101010001
        10010000000001D1010101001
1111111110110000011101D1000000001
1000000000110000011101D1111101111
11110111111111011100000010001
111101111111110111010100D0001    
11000000110101011100000010001    
10000000000000000D00N000D0001
10000000000000001100000010001
1100000111010101110000111000111  
11110101 1111101 101111010001
11111111 111 111 111111111111