        1111111111111111111111111
        1000100001100000000000001
        1011011001110DD1101010001
        10010000000001D1010101001
1111111110110000011101D10D0000001
1000000000110000011101D1101001111
11110111111111011100000W1D1D1
111101111111110111010100D0001    
11000000110101011100000010001    
10000000000000000D000000D0001
10000000000000001100000010001
1100000111010101110000111000111  
11110101 1111101 101111010001
11111111 111 111 111111111111